財前時子	passion
三村かな子	cute
鷹富士茄子	cool
諸星きらり	passion
双葉杏	cute
向井拓海	passion
クラリス	cute
桐生つかさ	cool
緒方智絵里	cute
本田未央	passion
ライラ	cool
大槻唯	passion
工藤忍	cute
堀裕子	passion
速水奏	cool
アナスタシア	cool
古賀小春	cute
三好紗南	passion
橘ありす	cool
市原仁奈	passion
島村卯月	cute
ナターリア	passion
西園寺琴歌	cute
高垣楓	cool
佐藤心	passion
森久保乃々	cool
十時愛梨	passion
今井加奈	cute
川島瑞樹	cool
難波笑美	passion
塩見周子	cool
中野有香	cute
白菊ほたる	cute
的場梨沙	passion
脇山珠美	cool
及川雫	passion
輿水幸子	cute
前川みく	cute
大和亜季	cool
棟方愛海	cute
木村夏樹	passion
渋谷凛	cool
道明寺歌鈴	cute
村上巴	passion
佐々木千枝	cool
遊佐こずえ	cute
姫川友紀	passion
白坂小梅	cool
藤本里奈	cute
日野茜	passion
佐城雪美	cool
乙倉悠貴	cute
城ヶ崎莉嘉	passion
関裕美	cute
松永涼	cool
片桐早苗	passion
三船美優	cool
五十嵐響子	cute
喜多見柚	passion
多田李衣菜	cool
椎名法子	cute
相葉夕美	passion
二宮飛鳥	cool
八神マキノ	cool
赤城みりあ	passion
小早川紗枝	cute
依田芳乃	passion
安部菜々	cute
荒木比奈	cool
水本ゆかり	cute
龍崎薫	passion
宮本フレデリカ	cute
神谷奈緒	cool
櫻井桃華	cute
高森藍子	passion
北条加蓮	cool
藤原肇	cool
浜口あやめ	passion
佐久間まゆ	cute
星輝子	passion
城ヶ崎美嘉	passion
小日向美穂	cute
一ノ瀬志希	cute
鷺沢文香	cool
上条春菜	cool
早坂美玲	cute
新田美波	cool
神崎蘭子	cool
喜多日菜子	passion
